"DualShock4"
{
"origin_ps4_button_x"	"Бутон X"
"[english]origin_ps4_button_x"	"X Button"
"origin_ps4_button_circle"	"Бутон 〇"
"[english]origin_ps4_button_circle"	"Circle Button"
"origin_ps4_button_square"	"Бутон ☐"
"[english]origin_ps4_button_square"	"Square Button"
"origin_ps4_button_triangle"	"Бутон △"
"[english]origin_ps4_button_triangle"	"Triangle Button"
"origin_ps4_pad_l_touch"	"Допир на левия пад"
"[english]origin_ps4_pad_l_touch"	"Left Pad Touch"
"origin_ps4_pad_l_swipe"	"Замах по левия пад"
"[english]origin_ps4_pad_l_swipe"	"Left Pad Swipe"
"origin_ps4_pad_l_click"	"Кликване с ляв пад"
"[english]origin_ps4_pad_l_click"	"Left Pad Click"
"origin_ps4_pad_l_dpad_n"	"Ляв пад нагоре"
"[english]origin_ps4_pad_l_dpad_n"	"Left Pad Up"
"origin_ps4_pad_l_dpad_s"	"Ляв пад надолу"
"[english]origin_ps4_pad_l_dpad_s"	"Left Pad Down"
"origin_ps4_pad_l_dpad_w"	"Ляв пад наляво"
"[english]origin_ps4_pad_l_dpad_w"	"Left Pad Left"
"origin_ps4_pad_l_dpad_e"	"Ляв пад надясно"
"[english]origin_ps4_pad_l_dpad_e"	"Left Pad Right"
"origin_ps4_pad_r_touch"	"Допир на десния пад"
"[english]origin_ps4_pad_r_touch"	"Right Pad Touch"
"origin_ps4_pad_r_swipe"	"Замах по десния пад"
"[english]origin_ps4_pad_r_swipe"	"Right Pad Swipe"
"origin_ps4_pad_r_click"	"Кликване с десен пад"
"[english]origin_ps4_pad_r_click"	"Right Pad Click"
"origin_ps4_pad_r_dpad_n"	"Десен пад нагоре"
"[english]origin_ps4_pad_r_dpad_n"	"Right Pad Up"
"origin_ps4_pad_r_dpad_s"	"Десен пад надолу"
"[english]origin_ps4_pad_r_dpad_s"	"Right Pad Down"
"origin_ps4_pad_r_dpad_w"	"Десен пад наляво"
"[english]origin_ps4_pad_r_dpad_w"	"Right Pad Left"
"origin_ps4_pad_r_dpad_e"	"Десен пад надясно"
"[english]origin_ps4_pad_r_dpad_e"	"Right Pad Right"
"origin_ps4_pad_center_touch"	"Допир на централния пад"
"[english]origin_ps4_pad_center_touch"	"Center Pad Touch"
"origin_ps4_pad_center_swipe"	"Замах по централния пад"
"[english]origin_ps4_pad_center_swipe"	"Center Pad Swipe"
"origin_ps4_pad_center_click"	"Кликване с централен пад"
"[english]origin_ps4_pad_center_click"	"Center Pad Click"
"origin_ps4_pad_center_dpad_n"	"Централен пад нагоре"
"[english]origin_ps4_pad_center_dpad_n"	"Center Pad Up"
"origin_ps4_pad_center_dpad_s"	"Централен пад надолу"
"[english]origin_ps4_pad_center_dpad_s"	"Center Pad Down"
"origin_ps4_pad_center_dpad_w"	"Централен пад наляво"
"[english]origin_ps4_pad_center_dpad_w"	"Center Pad Left"
"origin_ps4_pad_center_dpad_e"	"Централен пад надясно"
"[english]origin_ps4_pad_center_dpad_e"	"Center Pad Right"
"origin_ps4_trigger_l_pull"	"Ляв спусък (L2)"
"[english]origin_ps4_trigger_l_pull"	"Left Trigger (L2)"
"origin_ps4_trigger_l_click"	"Пълно издърпване на левия спусък (L2)"
"[english]origin_ps4_trigger_l_click"	"Left Trigger (L2) Full Pull"
"origin_ps4_trigger_r_pull"	"Десен спусък (R2)"
"[english]origin_ps4_trigger_r_pull"	"Right Trigger (R2)"
"origin_ps4_trigger_r_click"	"Пълно издърпване на десния спусък (R2)"
"[english]origin_ps4_trigger_r_click"	"Right Trigger (R2) Full Pull"
"origin_ps4_stick_l_move"	"Движение на левия стик"
"[english]origin_ps4_stick_l_move"	"Left Stick Movement"
"origin_ps4_stick_l_click"	"Клик с ляв стик"
"[english]origin_ps4_stick_l_click"	"Left Stick Click"
"origin_ps4_stick_l_dpad_n"	"Ляв стик движение нагоре"
"[english]origin_ps4_stick_l_dpad_n"	"Left Stick Move Up"
"origin_ps4_stick_l_dpad_s"	"Ляв стик движение надолу"
"[english]origin_ps4_stick_l_dpad_s"	"Left Stick Move Down"
"origin_ps4_stick_l_dpad_w"	"Ляв стик движение наляво"
"[english]origin_ps4_stick_l_dpad_w"	"Left Stick Move Left"
"origin_ps4_stick_l_dpad_e"	"Ляв стик движение надясно"
"[english]origin_ps4_stick_l_dpad_e"	"Left Stick Move Right"
"origin_ps4_stick_r_move"	"Движение на десния стик"
"[english]origin_ps4_stick_r_move"	"Right Stick Movement"
"origin_ps4_stick_r_click"	"Клик с десен стик"
"[english]origin_ps4_stick_r_click"	"Right Stick Click"
"origin_ps4_stick_r_dpad_n"	"Десен стик движение нагоре"
"[english]origin_ps4_stick_r_dpad_n"	"Right Stick Move Up"
"origin_ps4_stick_r_dpad_s"	"Десен стик движение надолу"
"[english]origin_ps4_stick_r_dpad_s"	"Right Stick Move Down"
"origin_ps4_stick_r_dpad_w"	"Десен стик движение наляво"
"[english]origin_ps4_stick_r_dpad_w"	"Right Stick Move Left"
"origin_ps4_stick_r_dpad_e"	"Десен стик движение надясно"
"[english]origin_ps4_stick_r_dpad_e"	"Right Stick Move Right"
"origin_ps4_button_dpad_n"	"Д-пад нагоре"
"[english]origin_ps4_button_dpad_n"	"D-Pad Up"
"origin_ps4_button_dpad_s"	"Д-пад надолу"
"[english]origin_ps4_button_dpad_s"	"D-Pad Down"
"origin_ps4_button_dpad_w"	"Д-пад наляво"
"[english]origin_ps4_button_dpad_w"	"D-Pad Left"
"origin_ps4_button_dpad_e"	"Д-пад надясно"
"[english]origin_ps4_button_dpad_e"	"D-Pad Right"
"origin_ps4_gyro_move"	"Жироскопично движение"
"[english]origin_ps4_gyro_move"	"Gyro Move"
"origin_ps4_gyro_pitch"	"Наклон на жироскопа"
"[english]origin_ps4_gyro_pitch"	"Gyro Pitch"
"origin_ps4_gyro_yaw"	"Ъглово завъртане на жироскопа"
"[english]origin_ps4_gyro_yaw"	"Gyro Yaw"
"origin_ps4_gyro_roll"	"Преобръщане на жироскопа"
"[english]origin_ps4_gyro_roll"	"Gyro Roll"
"origin_ps4_shoulder_l"	"Ляв бутон отзад (L1)"
"[english]origin_ps4_shoulder_l"	"Left Shoulder (L1)"
"origin_ps4_shoulder_r"	"Десен бутон отзад (R1)"
"[english]origin_ps4_shoulder_r"	"Right Shoulder (R1)"
"origin_ps4_button_options"	"Бутон Options"
"[english]origin_ps4_button_options"	"Options Button"
"origin_ps4_button_share"	"Бутон Share"
"[english]origin_ps4_button_share"	"Share Button"
}
