"DualShock4"
{
"origin_ps4_button_x"	"X-knop"
"[english]origin_ps4_button_x"	"X Button"
"origin_ps4_button_circle"	"Cirkelknop"
"[english]origin_ps4_button_circle"	"Circle Button"
"origin_ps4_button_square"	"Vierkantknop"
"[english]origin_ps4_button_square"	"Square Button"
"origin_ps4_button_triangle"	"Driehoekknop"
"[english]origin_ps4_button_triangle"	"Triangle Button"
"origin_ps4_stick_l_dpad_n"	"Linkerstick - omhoog"
"[english]origin_ps4_stick_l_dpad_n"	"Left Stick Move Up"
"origin_ps4_stick_r_dpad_n"	"Rechterstick - omhoog"
"[english]origin_ps4_stick_r_dpad_n"	"Right Stick Move Up"
"origin_ps4_button_dpad_n"	"Vierpuntsdruktoets omhoog"
"[english]origin_ps4_button_dpad_n"	"D-Pad Up"
"origin_ps4_button_dpad_s"	"Vierpuntsdruktoets omlaag"
"[english]origin_ps4_button_dpad_s"	"D-Pad Down"
"origin_ps4_button_dpad_w"	"Vierpuntsdruktoets links"
"[english]origin_ps4_button_dpad_w"	"D-Pad Left"
"origin_ps4_button_dpad_e"	"Vierpuntsdruktoets rechts"
"[english]origin_ps4_button_dpad_e"	"D-Pad Right"
"origin_ps4_button_options"	"Options-knop"
"[english]origin_ps4_button_options"	"Options Button"
"origin_ps4_button_share"	"Share-knop"
"[english]origin_ps4_button_share"	"Share Button"
}
