"DualShock4"
{
"origin_ps4_button_x"	"Buton X"
"[english]origin_ps4_button_x"	"X Button"
"origin_ps4_trigger_l_pull"	"Trigger stânga (L2)"
"[english]origin_ps4_trigger_l_pull"	"Left Trigger (L2)"
"origin_ps4_trigger_l_click"	"Tragere completă a triggerului stânga (L2)"
"[english]origin_ps4_trigger_l_click"	"Left Trigger (L2) Full Pull"
"origin_ps4_stick_l_move"	"Mișcarea stickului stânga"
"[english]origin_ps4_stick_l_move"	"Left Stick Movement"
"origin_ps4_stick_l_click"	"Clicul stickului stânga"
"[english]origin_ps4_stick_l_click"	"Left Stick Click"
"origin_ps4_stick_r_move"	"Mișcarea stickului dreapta"
"[english]origin_ps4_stick_r_move"	"Right Stick Movement"
"origin_ps4_stick_r_click"	"Clicul stickului dreapta"
"[english]origin_ps4_stick_r_click"	"Right Stick Click"
"origin_ps4_stick_r_dpad_n"	"Mișcare în sus a stickului dreapta"
"[english]origin_ps4_stick_r_dpad_n"	"Right Stick Move Up"
"origin_ps4_stick_r_dpad_s"	"Mișcare în jos a stickului dreapta"
"[english]origin_ps4_stick_r_dpad_s"	"Right Stick Move Down"
"origin_ps4_stick_r_dpad_w"	"Mișcare în stânga a stickului dreapta"
"[english]origin_ps4_stick_r_dpad_w"	"Right Stick Move Left"
"origin_ps4_stick_r_dpad_e"	"Mișcare în dreapta a stickului dreapta"
"[english]origin_ps4_stick_r_dpad_e"	"Right Stick Move Right"
"origin_ps4_shoulder_l"	"Shoulder stânga (L1)"
"[english]origin_ps4_shoulder_l"	"Left Shoulder (L1)"
"origin_ps4_shoulder_r"	"Shoulder dreapta (R1)"
"[english]origin_ps4_shoulder_r"	"Right Shoulder (R1)"
"origin_ps4_button_share"	"Buton share"
"[english]origin_ps4_button_share"	"Share Button"
}
