"SteamController"
{
"origin_none"	"Ingen"
"[english]origin_none"	"None"
"origin_steamcontroller_button_a"	"A-knapp"
"[english]origin_steamcontroller_button_a"	"A Button"
"origin_steamcontroller_button_b"	"B-knapp"
"[english]origin_steamcontroller_button_b"	"B Button"
"origin_steamcontroller_button_x"	"X-knapp"
"[english]origin_steamcontroller_button_x"	"X Button"
"origin_steamcontroller_button_y"	"Y-knapp"
"[english]origin_steamcontroller_button_y"	"Y Button"
"origin_steamcontroller_pad_l_touch"	"Vänster styrplatta - Vidrörning"
"[english]origin_steamcontroller_pad_l_touch"	"Left Pad Touch"
"origin_steamcontroller_pad_l_swipe"	"Vänster styrplatta - Svep"
"[english]origin_steamcontroller_pad_l_swipe"	"Left Pad Swipe"
"origin_steamcontroller_pad_l_click"	"Vänster styrplatta - Klick"
"[english]origin_steamcontroller_pad_l_click"	"Left Pad Click"
"origin_steamcontroller_pad_l_dpad_n"	"Vänster styrplatta - Upp"
"[english]origin_steamcontroller_pad_l_dpad_n"	"Left Pad Up"
"origin_steamcontroller_pad_l_dpad_s"	"Vänster styrplatta - Ned"
"[english]origin_steamcontroller_pad_l_dpad_s"	"Left Pad Down"
"origin_steamcontroller_pad_l_dpad_w"	"Vänster styrplatta - Vänster"
"[english]origin_steamcontroller_pad_l_dpad_w"	"Left Pad Left"
"origin_steamcontroller_pad_l_dpad_e"	"Vänster styrplatta - Höger"
"[english]origin_steamcontroller_pad_l_dpad_e"	"Left Pad Right"
"origin_steamcontroller_pad_r_touch"	"Höger styrplatta - Vidrörning"
"[english]origin_steamcontroller_pad_r_touch"	"Right Pad Touch"
"origin_steamcontroller_pad_r_swipe"	"Höger styrplatta - Svep"
"[english]origin_steamcontroller_pad_r_swipe"	"Right Pad Swipe"
"origin_steamcontroller_pad_r_click"	"Höger styrplatta - Klick"
"[english]origin_steamcontroller_pad_r_click"	"Right Pad Click"
"origin_steamcontroller_pad_r_dpad_n"	"Höger styrplatta - Upp"
"[english]origin_steamcontroller_pad_r_dpad_n"	"Right Pad Up"
"origin_steamcontroller_pad_r_dpad_s"	"Höger styrplatta - Ner"
"[english]origin_steamcontroller_pad_r_dpad_s"	"Right Pad Down"
"origin_steamcontroller_pad_r_dpad_w"	"Höger styrplatta - Vänster"
"[english]origin_steamcontroller_pad_r_dpad_w"	"Right Pad Left"
"origin_steamcontroller_pad_r_dpad_e"	"Höger styrplatta - Höger"
"[english]origin_steamcontroller_pad_r_dpad_e"	"Right Pad Right"
"origin_steamcontroller_trigger_l_pull"	"Vänster avtryckare"
"[english]origin_steamcontroller_trigger_l_pull"	"Left Trigger"
"origin_steamcontroller_trigger_l_click"	"Vänster avtryckare - Klick"
"[english]origin_steamcontroller_trigger_l_click"	"Left Trigger Click"
"origin_steamcontroller_trigger_r_pull"	"Höger avtryckare"
"[english]origin_steamcontroller_trigger_r_pull"	"Right Trigger"
"origin_steamcontroller_trigger_r_click"	"Höger avtryckare - Klick"
"[english]origin_steamcontroller_trigger_r_click"	"Right Trigger Click"
"origin_steamcontroller_stick_move"	"Styrspaksrörelse"
"[english]origin_steamcontroller_stick_move"	"Stick Movement"
"origin_steamcontroller_stick_click"	"Styrspaksklick"
"[english]origin_steamcontroller_stick_click"	"Stick Click"
"origin_steamcontroller_stick_dpad_n"	"Styrspak - Flytta upp"
"[english]origin_steamcontroller_stick_dpad_n"	"Stick Move Up"
"origin_steamcontroller_stick_dpad_s"	"Styrspak - Flytta ned"
"[english]origin_steamcontroller_stick_dpad_s"	"Stick Move Down"
"origin_steamcontroller_stick_dpad_w"	"Styrspak - Flytta vänster"
"[english]origin_steamcontroller_stick_dpad_w"	"Stick Move Left"
"origin_steamcontroller_stick_dpad_e"	"Styrspak - Flytta höger"
"[english]origin_steamcontroller_stick_dpad_e"	"Stick Move Right"
"origin_steamcontroller_gyro_move"	"Gyrorörelse"
"[english]origin_steamcontroller_gyro_move"	"Gyro Move"
"origin_steamcontroller_gyro_pitch"	"Gyrolutning"
"[english]origin_steamcontroller_gyro_pitch"	"Gyro Pitch"
"origin_steamcontroller_gyro_yaw"	"Gyrogirning"
"[english]origin_steamcontroller_gyro_yaw"	"Gyro Yaw"
"origin_steamcontroller_gyro_roll"	"Gyrorullning"
"[english]origin_steamcontroller_gyro_roll"	"Gyro Roll"
"origin_steamcontroller_shoulder_l"	"Vänster kantknapp"
"[english]origin_steamcontroller_shoulder_l"	"Left Shoulder Button"
"origin_steamcontroller_shoulder_r"	"Höger kantknapp"
"[english]origin_steamcontroller_shoulder_r"	"Right Shoulder Button"
"origin_steamcontroller_grip_l"	"Vänster grepp"
"[english]origin_steamcontroller_grip_l"	"Left Grip"
"origin_steamcontroller_grip_r"	"Höger grepp"
"[english]origin_steamcontroller_grip_r"	"Right Grip"
"origin_steamcontroller_button_start"	"Start"
"[english]origin_steamcontroller_button_start"	"Start"
"origin_steamcontroller_button_select"	"Select"
"[english]origin_steamcontroller_button_select"	"Select"
}
