"SteamController"
{
"origin_none"	"无"
"[english]origin_none"	"None"
"origin_steamcontroller_button_a"	"A 键"
"[english]origin_steamcontroller_button_a"	"A Button"
"origin_steamcontroller_button_b"	"B 键"
"[english]origin_steamcontroller_button_b"	"B Button"
"origin_steamcontroller_button_x"	"X 键"
"[english]origin_steamcontroller_button_x"	"X Button"
"origin_steamcontroller_button_y"	"Y 键"
"[english]origin_steamcontroller_button_y"	"Y Button"
"origin_steamcontroller_pad_l_touch"	"左触板触摸"
"[english]origin_steamcontroller_pad_l_touch"	"Left Pad Touch"
"origin_steamcontroller_pad_l_swipe"	"左侧触控板滑动"
"[english]origin_steamcontroller_pad_l_swipe"	"Left Pad Swipe"
"origin_steamcontroller_pad_l_click"	"左触板点击"
"[english]origin_steamcontroller_pad_l_click"	"Left Pad Click"
"origin_steamcontroller_pad_l_dpad_n"	"左侧触控板向上"
"[english]origin_steamcontroller_pad_l_dpad_n"	"Left Pad Up"
"origin_steamcontroller_pad_l_dpad_s"	"左侧触控板向下"
"[english]origin_steamcontroller_pad_l_dpad_s"	"Left Pad Down"
"origin_steamcontroller_pad_l_dpad_w"	"左侧触控板向左"
"[english]origin_steamcontroller_pad_l_dpad_w"	"Left Pad Left"
"origin_steamcontroller_pad_l_dpad_e"	"左侧触控板向右"
"[english]origin_steamcontroller_pad_l_dpad_e"	"Left Pad Right"
"origin_steamcontroller_pad_r_touch"	"右触板触摸"
"[english]origin_steamcontroller_pad_r_touch"	"Right Pad Touch"
"origin_steamcontroller_pad_r_swipe"	"右侧触控板滑动"
"[english]origin_steamcontroller_pad_r_swipe"	"Right Pad Swipe"
"origin_steamcontroller_pad_r_click"	"右触板点击"
"[english]origin_steamcontroller_pad_r_click"	"Right Pad Click"
"origin_steamcontroller_pad_r_dpad_n"	"右侧触控板向上"
"[english]origin_steamcontroller_pad_r_dpad_n"	"Right Pad Up"
"origin_steamcontroller_pad_r_dpad_s"	"右侧触控板向下"
"[english]origin_steamcontroller_pad_r_dpad_s"	"Right Pad Down"
"origin_steamcontroller_pad_r_dpad_w"	"右侧触控板向左"
"[english]origin_steamcontroller_pad_r_dpad_w"	"Right Pad Left"
"origin_steamcontroller_pad_r_dpad_e"	"右侧触控板向右"
"[english]origin_steamcontroller_pad_r_dpad_e"	"Right Pad Right"
"origin_steamcontroller_trigger_l_pull"	"左侧扳机键"
"[english]origin_steamcontroller_trigger_l_pull"	"Left Trigger"
"origin_steamcontroller_trigger_l_click"	"左扳机点击"
"[english]origin_steamcontroller_trigger_l_click"	"Left Trigger Click"
"origin_steamcontroller_trigger_r_pull"	"右侧扳机键"
"[english]origin_steamcontroller_trigger_r_pull"	"Right Trigger"
"origin_steamcontroller_trigger_r_click"	"右扳机点击"
"[english]origin_steamcontroller_trigger_r_click"	"Right Trigger Click"
"origin_steamcontroller_stick_move"	"摇杆移动"
"[english]origin_steamcontroller_stick_move"	"Stick Movement"
"origin_steamcontroller_stick_click"	"摇杆点击"
"[english]origin_steamcontroller_stick_click"	"Stick Click"
"origin_steamcontroller_stick_dpad_n"	"摇杆向上"
"[english]origin_steamcontroller_stick_dpad_n"	"Stick Move Up"
"origin_steamcontroller_stick_dpad_s"	"摇杆向下"
"[english]origin_steamcontroller_stick_dpad_s"	"Stick Move Down"
"origin_steamcontroller_stick_dpad_w"	"摇杆向左"
"[english]origin_steamcontroller_stick_dpad_w"	"Stick Move Left"
"origin_steamcontroller_stick_dpad_e"	"摇杆向右"
"[english]origin_steamcontroller_stick_dpad_e"	"Stick Move Right"
"origin_steamcontroller_gyro_move"	"陀螺仪移动"
"[english]origin_steamcontroller_gyro_move"	"Gyro Move"
"origin_steamcontroller_gyro_pitch"	"陀螺仪倾斜"
"[english]origin_steamcontroller_gyro_pitch"	"Gyro Pitch"
"origin_steamcontroller_gyro_yaw"	"陀螺仪偏航"
"[english]origin_steamcontroller_gyro_yaw"	"Gyro Yaw"
"origin_steamcontroller_gyro_roll"	"陀螺仪滚转"
"[english]origin_steamcontroller_gyro_roll"	"Gyro Roll"
"origin_steamcontroller_shoulder_l"	"左缓冲键"
"[english]origin_steamcontroller_shoulder_l"	"Left Shoulder Button"
"origin_steamcontroller_shoulder_r"	"右缓冲键"
"[english]origin_steamcontroller_shoulder_r"	"Right Shoulder Button"
"origin_steamcontroller_grip_l"	"LG 键"
"[english]origin_steamcontroller_grip_l"	"Left Grip"
"origin_steamcontroller_grip_r"	"RG 键"
"[english]origin_steamcontroller_grip_r"	"Right Grip"
"origin_steamcontroller_button_start"	"START 键"
"[english]origin_steamcontroller_button_start"	"Start"
"origin_steamcontroller_button_select"	"SELECT 键"
"[english]origin_steamcontroller_button_select"	"Select"
}
