"SwitchController"
{
"origin_none"	"Κανένα"
"[english]origin_none"	"None"
"origin_switch_button_a"	"Κουμπί A"
"[english]origin_switch_button_a"	"A Button"
"origin_switch_button_b"	"Κουμπί B"
"[english]origin_switch_button_b"	"B Button"
"origin_switch_button_x"	"Κουμπί X"
"[english]origin_switch_button_x"	"X Button"
"origin_switch_button_y"	"Κουμπί Y"
"[english]origin_switch_button_y"	"Y Button"
"origin_switch_button_plus"	"Κουμπί +"
"[english]origin_switch_button_plus"	"Plus Button"
"origin_switch_button_minus"	"Κουμπί -"
"[english]origin_switch_button_minus"	"Minus Button"
"origin_switch_button_capture"	"Κουμπί Capture"
"[english]origin_switch_button_capture"	"Capture Button"
"origin_switch_trigger_l_pull"	"Αριστερή σκανδάλη (ZL)"
"[english]origin_switch_trigger_l_pull"	"Left Trigger (ZL)"
"origin_switch_trigger_l_click"	"Πλήρες πάτημα αριστερής σκανδάλης (ZL)"
"[english]origin_switch_trigger_l_click"	"Left Trigger (ZL) Full Pull"
"origin_switch_trigger_r_pull"	"Δεξιά σκανδάλη (ZR)"
"[english]origin_switch_trigger_r_pull"	"Right Trigger (ZR)"
"origin_switch_trigger_r_click"	"Πλήρες πάτημα δεξιάς σκανδάλης (ZR)"
"[english]origin_switch_trigger_r_click"	"Right Trigger (ZR) Full Pull"
"origin_switch_stick_l_move"	"Κίνηση αριστερού μοχλού"
"[english]origin_switch_stick_l_move"	"Left Stick Movement"
"origin_switch_stick_l_click"	"Πάτημα αριστερού μοχλού"
"[english]origin_switch_stick_l_click"	"Left Stick Click"
"origin_switch_stick_l_dpad_n"	"Κίνηση αριστερού μοχλού πάνω"
"[english]origin_switch_stick_l_dpad_n"	"Left Stick Move Up"
"origin_switch_stick_l_dpad_s"	"Κίνηση αριστερού μοχλού κάτω"
"[english]origin_switch_stick_l_dpad_s"	"Left Stick Move Down"
"origin_switch_stick_l_dpad_w"	"Κίνηση αριστερού μοχλού αριστερά"
"[english]origin_switch_stick_l_dpad_w"	"Left Stick Move Left"
"origin_switch_stick_l_dpad_e"	"Κίνηση αριστερού μοχλού δεξιά"
"[english]origin_switch_stick_l_dpad_e"	"Left Stick Move Right"
"origin_switch_stick_r_move"	"Κίνηση δεξιού μοχλού"
"[english]origin_switch_stick_r_move"	"Right Stick Movement"
"origin_switch_stick_r_click"	"Πάτημα δεξιού μοχλού"
"[english]origin_switch_stick_r_click"	"Right Stick Click"
"origin_switch_stick_r_dpad_n"	"Κίνηση δεξιού μοχλού πάνω"
"[english]origin_switch_stick_r_dpad_n"	"Right Stick Move Up"
"origin_switch_stick_r_dpad_s"	"Κίνηση δεξιού μοχλού κάτω"
"[english]origin_switch_stick_r_dpad_s"	"Right Stick Move Down"
"origin_switch_stick_r_dpad_w"	"Κίνηση δεξιού μοχλού αριστερά"
"[english]origin_switch_stick_r_dpad_w"	"Right Stick Move Left"
"origin_switch_stick_r_dpad_e"	"Κίνηση δεξιού μοχλού δεξιά"
"[english]origin_switch_stick_r_dpad_e"	"Right Stick Move Right"
"origin_switch_button_dpad_n"	"D-Pad πάνω"
"[english]origin_switch_button_dpad_n"	"D-Pad Up"
"origin_switch_button_dpad_s"	"D-Pad κάτω"
"[english]origin_switch_button_dpad_s"	"D-Pad Down"
"origin_switch_button_dpad_w"	"D-Pad αριστερά"
"[english]origin_switch_button_dpad_w"	"D-Pad Left"
"origin_switch_button_dpad_e"	"D-Pad δεξιά"
"[english]origin_switch_button_dpad_e"	"D-Pad Right"
"origin_switch_gyro_move"	"Κίνηση γυροσκοπίου"
"[english]origin_switch_gyro_move"	"Gyro Move"
"origin_switch_gyro_pitch"	"Ύψος γυροσκοπίου"
"[english]origin_switch_gyro_pitch"	"Gyro Pitch"
"origin_switch_gyro_yaw"	"Εκτροπή γυροσκοπίου"
"[english]origin_switch_gyro_yaw"	"Gyro Yaw"
"origin_switch_gyro_roll"	"Στροφή γυροσκοπίου"
"[english]origin_switch_gyro_roll"	"Gyro Roll"
"origin_switch_shoulder_l"	"Αριστερό μπροστινό κουμπί (L)"
"[english]origin_switch_shoulder_l"	"Left Shoulder (L)"
"origin_switch_shoulder_r"	"Δεξί μπροστινό κουμπί (R)"
"[english]origin_switch_shoulder_r"	"Right Shoulder (R)"
"origin_switch_l_joycon_sr"	"Αριστερή κάτω λαβή Joy-Con (SR)"
"[english]origin_switch_l_joycon_sr"	"Left Joycon Lower Grip (SR)"
"origin_switch_l_joycon_sl"	"Αριστερή πάνω λαβή Joy-Con (SL)"
"[english]origin_switch_l_joycon_sl"	"Left Joycon Upper Grip (SL)"
"origin_switch_r_joycon_sr"	"Δεξιά κάτω λαβή Joy-Con (SL)"
"[english]origin_switch_r_joycon_sr"	"Right Joycon Lower Grip (SL)"
"origin_switch_r_joycon_sl"	"Δεξιά πάνω λαβή Joy-Con (SR)"
"[english]origin_switch_r_joycon_sl"	"Right Joycon Upper Grip (SR)"
"origin_switch_l_gyro_move"	"Κίνηση αριστερού γυροσκοπίου Joy-Con"
"[english]origin_switch_l_gyro_move"	"Left JoyCon Gyro Move"
"origin_switch_l_gyro_pitch"	"Ύψος αριστερού γυροσκοπίου Joy-Con"
"[english]origin_switch_l_gyro_pitch"	"Left JoyCon Gyro Pitch"
"origin_switch_l_gyro_yaw"	"Εκτροπή αριστερού γυροσκοπίου Joy-Con"
"[english]origin_switch_l_gyro_yaw"	"Left JoyCon Gyro Yaw"
"origin_switch_l_gyro_roll"	"Στροφή αριστερού γυροσκοπίου Joy-Con"
"[english]origin_switch_l_gyro_roll"	"Left JoyCon Gyro Roll"
"origin_switch_r_gyro_move"	"Κίνηση δεξιού γυροσκοπίου Joy-Con"
"[english]origin_switch_r_gyro_move"	"Right JoyCon Gyro Move"
"origin_switch_r_gyro_pitch"	"Ύψος δεξιού γυροσκοπίου Joy-Con"
"[english]origin_switch_r_gyro_pitch"	"Right JoyCon Gyro Pitch"
"origin_switch_r_gyro_yaw"	"Εκτροπή δεξιού γυροσκοπίου Joy-Con"
"[english]origin_switch_r_gyro_yaw"	"Right JoyCon Gyro Yaw"
"origin_switch_r_yro_roll"	"Στροφή δεξιού γυροσκοπίου Joy-Con"
"[english]origin_switch_r_yro_roll"	"Right JoyCon Gyro Roll"
}
