"SwitchController"
{
"origin_none"	"Немає"
"[english]origin_none"	"None"
"origin_switch_button_a"	"Кнопка A"
"[english]origin_switch_button_a"	"A Button"
"origin_switch_button_b"	"Кнопка B"
"[english]origin_switch_button_b"	"B Button"
"origin_switch_button_x"	"Кнопка X"
"[english]origin_switch_button_x"	"X Button"
"origin_switch_button_y"	"Кнопка Y"
"[english]origin_switch_button_y"	"Y Button"
"origin_switch_button_plus"	"Кнопка +"
"[english]origin_switch_button_plus"	"Plus Button"
"origin_switch_button_minus"	"Кнопка -"
"[english]origin_switch_button_minus"	"Minus Button"
"origin_switch_button_capture"	"Кнопка захоплення"
"[english]origin_switch_button_capture"	"Capture Button"
"origin_switch_trigger_l_pull"	"Лівий триґер (ZL)"
"[english]origin_switch_trigger_l_pull"	"Left Trigger (ZL)"
"origin_switch_trigger_l_click"	"Повне натискання лівого триґера (ZL)"
"[english]origin_switch_trigger_l_click"	"Left Trigger (ZL) Full Pull"
"origin_switch_trigger_r_pull"	"Правий триґер (ZR)"
"[english]origin_switch_trigger_r_pull"	"Right Trigger (ZR)"
"origin_switch_trigger_r_click"	"Повне натискання правого триґера (ZR)"
"[english]origin_switch_trigger_r_click"	"Right Trigger (ZR) Full Pull"
"origin_switch_stick_l_move"	"Рух лівого стіка"
"[english]origin_switch_stick_l_move"	"Left Stick Movement"
"origin_switch_stick_l_click"	"Натискання лівого стіка"
"[english]origin_switch_stick_l_click"	"Left Stick Click"
"origin_switch_stick_l_dpad_n"	"Рух лівого стіка вгору"
"[english]origin_switch_stick_l_dpad_n"	"Left Stick Move Up"
"origin_switch_stick_l_dpad_s"	"Рух лівого стіка вниз"
"[english]origin_switch_stick_l_dpad_s"	"Left Stick Move Down"
"origin_switch_stick_l_dpad_w"	"Рух лівого стіка вліво"
"[english]origin_switch_stick_l_dpad_w"	"Left Stick Move Left"
"origin_switch_stick_l_dpad_e"	"Рух лівого стіка вправо"
"[english]origin_switch_stick_l_dpad_e"	"Left Stick Move Right"
"origin_switch_stick_r_move"	"Рух правого стіка"
"[english]origin_switch_stick_r_move"	"Right Stick Movement"
"origin_switch_stick_r_click"	"Натискання правого стіка"
"[english]origin_switch_stick_r_click"	"Right Stick Click"
"origin_switch_stick_r_dpad_n"	"Рух правого стіка вгору"
"[english]origin_switch_stick_r_dpad_n"	"Right Stick Move Up"
"origin_switch_stick_r_dpad_s"	"Рух правого стіка вниз"
"[english]origin_switch_stick_r_dpad_s"	"Right Stick Move Down"
"origin_switch_stick_r_dpad_w"	"Рух правого стіка вліво"
"[english]origin_switch_stick_r_dpad_w"	"Right Stick Move Left"
"origin_switch_stick_r_dpad_e"	"Рух правого стіка вправо"
"[english]origin_switch_stick_r_dpad_e"	"Right Stick Move Right"
"origin_switch_button_dpad_n"	"Хрестовина вгору"
"[english]origin_switch_button_dpad_n"	"D-Pad Up"
"origin_switch_button_dpad_s"	"Хрестовина вниз"
"[english]origin_switch_button_dpad_s"	"D-Pad Down"
"origin_switch_button_dpad_w"	"Хрестовина вліво"
"[english]origin_switch_button_dpad_w"	"D-Pad Left"
"origin_switch_button_dpad_e"	"Хрестовина вправо"
"[english]origin_switch_button_dpad_e"	"D-Pad Right"
"origin_switch_gyro_move"	"Рух гіроскопа"
"[english]origin_switch_gyro_move"	"Gyro Move"
"origin_switch_gyro_pitch"	"Тангаж гіроскопа"
"[english]origin_switch_gyro_pitch"	"Gyro Pitch"
"origin_switch_gyro_yaw"	"Рискання гіроскопа"
"[english]origin_switch_gyro_yaw"	"Gyro Yaw"
"origin_switch_gyro_roll"	"Крен гіроскопа"
"[english]origin_switch_gyro_roll"	"Gyro Roll"
"origin_switch_shoulder_l"	"Лівий бампер (L)"
"[english]origin_switch_shoulder_l"	"Left Shoulder (L)"
"origin_switch_shoulder_r"	"Правий бампер (R)"
"[english]origin_switch_shoulder_r"	"Right Shoulder (R)"
"origin_switch_l_joycon_sr"	"Лівий нижній хват Joy-Con (SR)"
"[english]origin_switch_l_joycon_sr"	"Left Joycon Lower Grip (SR)"
"origin_switch_l_joycon_sl"	"Лівий верхній хват Joy-Con (SL)"
"[english]origin_switch_l_joycon_sl"	"Left Joycon Upper Grip (SL)"
"origin_switch_r_joycon_sr"	"Правий нижній хват Joy-Con (SL)"
"[english]origin_switch_r_joycon_sr"	"Right Joycon Lower Grip (SL)"
"origin_switch_r_joycon_sl"	"Правий верхній хват Joy-Con (SR)"
"[english]origin_switch_r_joycon_sl"	"Right Joycon Upper Grip (SR)"
"origin_switch_l_gyro_move"	"Рух гіроскопа лівого Joy-Con"
"[english]origin_switch_l_gyro_move"	"Left JoyCon Gyro Move"
"origin_switch_l_gyro_pitch"	"Тангаж гіроскопа лівого Joy-Con"
"[english]origin_switch_l_gyro_pitch"	"Left JoyCon Gyro Pitch"
"origin_switch_l_gyro_yaw"	"Рискання гіроскопа лівого Joy-Con"
"[english]origin_switch_l_gyro_yaw"	"Left JoyCon Gyro Yaw"
"origin_switch_l_gyro_roll"	"Крен гіроскопа лівого Joy-Con"
"[english]origin_switch_l_gyro_roll"	"Left JoyCon Gyro Roll"
"origin_switch_r_gyro_move"	"Рух гіроскопа правого Joy-Con"
"[english]origin_switch_r_gyro_move"	"Right JoyCon Gyro Move"
"origin_switch_r_gyro_pitch"	"Тангаж гіроскопа правого Joy-Con"
"[english]origin_switch_r_gyro_pitch"	"Right JoyCon Gyro Pitch"
"origin_switch_r_gyro_yaw"	"Рискання гіроскопа правого Joy-Con"
"[english]origin_switch_r_gyro_yaw"	"Right JoyCon Gyro Yaw"
"origin_switch_r_yro_roll"	"Крен гіроскопа правого Joy-Con"
"[english]origin_switch_r_yro_roll"	"Right JoyCon Gyro Roll"
}
