"SwitchController"
{
"origin_none"	"Egyik sem"
"[english]origin_none"	"None"
"origin_switch_button_a"	"„A” gomb"
"[english]origin_switch_button_a"	"A Button"
"origin_switch_button_b"	"„B” gomb"
"[english]origin_switch_button_b"	"B Button"
"origin_switch_button_x"	"„X” gomb"
"[english]origin_switch_button_x"	"X Button"
"origin_switch_button_y"	"„Y” gomb"
"[english]origin_switch_button_y"	"Y Button"
"origin_switch_button_plus"	"„Plusz” gomb"
"[english]origin_switch_button_plus"	"Plus Button"
"origin_switch_button_minus"	"„Mínusz” gomb"
"[english]origin_switch_button_minus"	"Minus Button"
"origin_switch_button_capture"	"„Capture” gomb"
"[english]origin_switch_button_capture"	"Capture Button"
"origin_switch_trigger_l_pull"	"Bal ravasz (ZL)"
"[english]origin_switch_trigger_l_pull"	"Left Trigger (ZL)"
"origin_switch_trigger_l_click"	"Bal ravasz (ZL) teljes elhúzás"
"[english]origin_switch_trigger_l_click"	"Left Trigger (ZL) Full Pull"
"origin_switch_trigger_r_pull"	"Jobb ravasz (ZR)"
"[english]origin_switch_trigger_r_pull"	"Right Trigger (ZR)"
"origin_switch_trigger_r_click"	"Jobb ravasz (ZR) teljes elhúzás"
"[english]origin_switch_trigger_r_click"	"Right Trigger (ZR) Full Pull"
"origin_switch_stick_l_move"	"Bal kar mozgás"
"[english]origin_switch_stick_l_move"	"Left Stick Movement"
"origin_switch_stick_l_click"	"Bal kar kattintás"
"[english]origin_switch_stick_l_click"	"Left Stick Click"
"origin_switch_stick_l_dpad_n"	"Bal kar fel"
"[english]origin_switch_stick_l_dpad_n"	"Left Stick Move Up"
"origin_switch_stick_l_dpad_s"	"Bal kar le"
"[english]origin_switch_stick_l_dpad_s"	"Left Stick Move Down"
"origin_switch_stick_l_dpad_w"	"Bal kar balra"
"[english]origin_switch_stick_l_dpad_w"	"Left Stick Move Left"
"origin_switch_stick_l_dpad_e"	"Bal kar jobbra"
"[english]origin_switch_stick_l_dpad_e"	"Left Stick Move Right"
"origin_switch_stick_r_move"	"Jobb kar mozgás"
"[english]origin_switch_stick_r_move"	"Right Stick Movement"
"origin_switch_stick_r_click"	"Jobb kar kattintás"
"[english]origin_switch_stick_r_click"	"Right Stick Click"
"origin_switch_stick_r_dpad_n"	"Jobb kar fel"
"[english]origin_switch_stick_r_dpad_n"	"Right Stick Move Up"
"origin_switch_stick_r_dpad_s"	"Jobb kar le"
"[english]origin_switch_stick_r_dpad_s"	"Right Stick Move Down"
"origin_switch_stick_r_dpad_w"	"Jobb kar balra"
"[english]origin_switch_stick_r_dpad_w"	"Right Stick Move Left"
"origin_switch_stick_r_dpad_e"	"Jobb kar jobbra"
"[english]origin_switch_stick_r_dpad_e"	"Right Stick Move Right"
"origin_switch_button_dpad_n"	"Fel iránygomb"
"[english]origin_switch_button_dpad_n"	"D-Pad Up"
"origin_switch_button_dpad_s"	"Le iránygomb"
"[english]origin_switch_button_dpad_s"	"D-Pad Down"
"origin_switch_button_dpad_w"	"Balra iránygomb"
"[english]origin_switch_button_dpad_w"	"D-Pad Left"
"origin_switch_button_dpad_e"	"Jobbra iránygomb"
"[english]origin_switch_button_dpad_e"	"D-Pad Right"
"origin_switch_gyro_move"	"Giro mozgatás"
"[english]origin_switch_gyro_move"	"Gyro Move"
"origin_switch_gyro_pitch"	"Giro orrszög"
"[english]origin_switch_gyro_pitch"	"Gyro Pitch"
"origin_switch_gyro_yaw"	"Giro oldalszög"
"[english]origin_switch_gyro_yaw"	"Gyro Yaw"
"origin_switch_gyro_roll"	"Giro elfordulás"
"[english]origin_switch_gyro_roll"	"Gyro Roll"
"origin_switch_shoulder_l"	"Bal vállgomb (L)"
"[english]origin_switch_shoulder_l"	"Left Shoulder (L)"
"origin_switch_shoulder_r"	"Jobb vállgomb (R)"
"[english]origin_switch_shoulder_r"	"Right Shoulder (R)"
"origin_switch_l_joycon_sr"	"Bal Joy-Con alsó markolat (SR)"
"[english]origin_switch_l_joycon_sr"	"Left Joycon Lower Grip (SR)"
"origin_switch_l_joycon_sl"	"Bal Joy-Con felső markolat (SL)"
"[english]origin_switch_l_joycon_sl"	"Left Joycon Upper Grip (SL)"
"origin_switch_r_joycon_sr"	"Jobb Joy-Con alsó markolat (SL)"
"[english]origin_switch_r_joycon_sr"	"Right Joycon Lower Grip (SL)"
"origin_switch_r_joycon_sl"	"Jobb Joy-Con felső markolat (SR)"
"[english]origin_switch_r_joycon_sl"	"Right Joycon Upper Grip (SR)"
"origin_switch_l_gyro_move"	"Bal Joy-Con giro mozgatás"
"[english]origin_switch_l_gyro_move"	"Left JoyCon Gyro Move"
"origin_switch_l_gyro_pitch"	"Bal Joy-Con giro orrszög"
"[english]origin_switch_l_gyro_pitch"	"Left JoyCon Gyro Pitch"
"origin_switch_l_gyro_yaw"	"Bal Joy-Con giro oldalszög"
"[english]origin_switch_l_gyro_yaw"	"Left JoyCon Gyro Yaw"
"origin_switch_l_gyro_roll"	"Bal Joy-Con giro elfordulás"
"[english]origin_switch_l_gyro_roll"	"Left JoyCon Gyro Roll"
"origin_switch_r_gyro_move"	"Jobb Joy-Con giro mozgatás"
"[english]origin_switch_r_gyro_move"	"Right JoyCon Gyro Move"
"origin_switch_r_gyro_pitch"	"Jobb Joy-Con giro orrszög"
"[english]origin_switch_r_gyro_pitch"	"Right JoyCon Gyro Pitch"
"origin_switch_r_gyro_yaw"	"Jobb Joy-Con giro oldalszög"
"[english]origin_switch_r_gyro_yaw"	"Right JoyCon Gyro Yaw"
"origin_switch_r_yro_roll"	"Jobb Joy-Con giro elfordulás"
"[english]origin_switch_r_yro_roll"	"Right JoyCon Gyro Roll"
}
