"SwitchController"
{
"origin_none"	"Brak"
"[english]origin_none"	"None"
"origin_switch_button_a"	"Przycisk A"
"[english]origin_switch_button_a"	"A Button"
"origin_switch_button_b"	"Przycisk B"
"[english]origin_switch_button_b"	"B Button"
"origin_switch_button_x"	"Przycisk X"
"[english]origin_switch_button_x"	"X Button"
"origin_switch_button_y"	"Przycisk Y"
"[english]origin_switch_button_y"	"Y Button"
"origin_switch_button_plus"	"Przycisk +"
"[english]origin_switch_button_plus"	"Plus Button"
"origin_switch_button_minus"	"Przycisk -"
"[english]origin_switch_button_minus"	"Minus Button"
"origin_switch_button_capture"	"Przycisk Capture"
"[english]origin_switch_button_capture"	"Capture Button"
"origin_switch_trigger_l_pull"	"Przycisk ZL"
"[english]origin_switch_trigger_l_pull"	"Left Trigger (ZL)"
"origin_switch_trigger_l_click"	"Przycisk ZL (pełne wciśnięcie)"
"[english]origin_switch_trigger_l_click"	"Left Trigger (ZL) Full Pull"
"origin_switch_trigger_r_pull"	"Przycisk ZR"
"[english]origin_switch_trigger_r_pull"	"Right Trigger (ZR)"
"origin_switch_trigger_r_click"	"Przycisk ZR (pełne wciśnięcie)"
"[english]origin_switch_trigger_r_click"	"Right Trigger (ZR) Full Pull"
"origin_switch_stick_l_move"	"Ruch lewą gałką"
"[english]origin_switch_stick_l_move"	"Left Stick Movement"
"origin_switch_stick_l_click"	"Kliknięcie lewą gałką"
"[english]origin_switch_stick_l_click"	"Left Stick Click"
"origin_switch_stick_l_dpad_n"	"Ruch lewą gałką w górę"
"[english]origin_switch_stick_l_dpad_n"	"Left Stick Move Up"
"origin_switch_stick_l_dpad_s"	"Ruch lewą gałką w dół"
"[english]origin_switch_stick_l_dpad_s"	"Left Stick Move Down"
"origin_switch_stick_l_dpad_w"	"Ruch lewą gałką w lewo"
"[english]origin_switch_stick_l_dpad_w"	"Left Stick Move Left"
"origin_switch_stick_l_dpad_e"	"Ruch lewą gałką w prawo"
"[english]origin_switch_stick_l_dpad_e"	"Left Stick Move Right"
"origin_switch_stick_r_move"	"Ruch prawą gałką"
"[english]origin_switch_stick_r_move"	"Right Stick Movement"
"origin_switch_stick_r_click"	"Kliknięcie prawą gałką"
"[english]origin_switch_stick_r_click"	"Right Stick Click"
"origin_switch_stick_r_dpad_n"	"Ruch prawą gałką w górę"
"[english]origin_switch_stick_r_dpad_n"	"Right Stick Move Up"
"origin_switch_stick_r_dpad_s"	"Ruch prawą gałką w dół"
"[english]origin_switch_stick_r_dpad_s"	"Right Stick Move Down"
"origin_switch_stick_r_dpad_w"	"Ruch prawą gałką w lewo"
"[english]origin_switch_stick_r_dpad_w"	"Right Stick Move Left"
"origin_switch_stick_r_dpad_e"	"Ruch prawą gałką w prawo"
"[english]origin_switch_stick_r_dpad_e"	"Right Stick Move Right"
"origin_switch_button_dpad_n"	"Przycisk Góra"
"[english]origin_switch_button_dpad_n"	"D-Pad Up"
"origin_switch_button_dpad_s"	"Przycisk Dół"
"[english]origin_switch_button_dpad_s"	"D-Pad Down"
"origin_switch_button_dpad_w"	"Przycisk Lewo"
"[english]origin_switch_button_dpad_w"	"D-Pad Left"
"origin_switch_button_dpad_e"	"Przycisk Prawo"
"[english]origin_switch_button_dpad_e"	"D-Pad Right"
"origin_switch_gyro_move"	"Ruch żyroskopu"
"[english]origin_switch_gyro_move"	"Gyro Move"
"origin_switch_gyro_pitch"	"Pochylenie żyroskopu"
"[english]origin_switch_gyro_pitch"	"Gyro Pitch"
"origin_switch_gyro_yaw"	"Odchylenie żyroskopu"
"[english]origin_switch_gyro_yaw"	"Gyro Yaw"
"origin_switch_gyro_roll"	"Przechylenie żyroskopu"
"[english]origin_switch_gyro_roll"	"Gyro Roll"
"origin_switch_shoulder_l"	"Przycisk L"
"[english]origin_switch_shoulder_l"	"Left Shoulder (L)"
"origin_switch_shoulder_r"	"Przycisk R"
"[english]origin_switch_shoulder_r"	"Right Shoulder (R)"
"origin_switch_l_joycon_sr"	"Przycisk SR lewego Joy-Cona"
"[english]origin_switch_l_joycon_sr"	"Left Joycon Lower Grip (SR)"
"origin_switch_l_joycon_sl"	"Przycisk SL lewego Joy-Cona"
"[english]origin_switch_l_joycon_sl"	"Left Joycon Upper Grip (SL)"
"origin_switch_r_joycon_sr"	"Przycisk SL prawego Joy-Cona"
"[english]origin_switch_r_joycon_sr"	"Right Joycon Lower Grip (SL)"
"origin_switch_r_joycon_sl"	"Przycisk SR prawego Joy-Cona"
"[english]origin_switch_r_joycon_sl"	"Right Joycon Upper Grip (SR)"
"origin_switch_l_gyro_move"	"Ruch żyroskopu lewego Joy-Cona"
"[english]origin_switch_l_gyro_move"	"Left JoyCon Gyro Move"
"origin_switch_l_gyro_pitch"	"Pochylenie żyroskopu lewego Joy-Cona"
"[english]origin_switch_l_gyro_pitch"	"Left JoyCon Gyro Pitch"
"origin_switch_l_gyro_yaw"	"Odchylenie żyroskopu lewego Joy-Cona"
"[english]origin_switch_l_gyro_yaw"	"Left JoyCon Gyro Yaw"
"origin_switch_l_gyro_roll"	"Przechylenie żyroskopu lewego Joy-Cona"
"[english]origin_switch_l_gyro_roll"	"Left JoyCon Gyro Roll"
"origin_switch_r_gyro_move"	"Ruch żyroskopu prawego Joy-Cona"
"[english]origin_switch_r_gyro_move"	"Right JoyCon Gyro Move"
"origin_switch_r_gyro_pitch"	"Pochylenie żyroskopu prawego Joy-Cona"
"[english]origin_switch_r_gyro_pitch"	"Right JoyCon Gyro Pitch"
"origin_switch_r_gyro_yaw"	"Odchylenie żyroskopu prawego Joy-Cona"
"[english]origin_switch_r_gyro_yaw"	"Right JoyCon Gyro Yaw"
"origin_switch_r_yro_roll"	"Przechylenie żyroskopu prawego Joy-Cona"
"[english]origin_switch_r_yro_roll"	"Right JoyCon Gyro Roll"
}
