"lang"
{
"Language"	"czech"
"Tokens"
{
"origin_xboxone_button_a"	"Tlačítko A"
"[english]origin_xboxone_button_a"	"A Button"
"origin_xboxone_button_b"	"Tlačítko B"
"[english]origin_xboxone_button_b"	"B Button"
"origin_xboxone_button_x"	"Tlačítko X"
"[english]origin_xboxone_button_x"	"X Button"
"origin_xboxone_button_y"	"Tlačítko Y"
"[english]origin_xboxone_button_y"	"Y Button"
"origin_xboxone_trigger_l_pull"	"Levá spoušť"
"[english]origin_xboxone_trigger_l_pull"	"Left Trigger"
"origin_xboxone_trigger_l_click"	"Levá spoušť – úplné stisknutí"
"[english]origin_xboxone_trigger_l_click"	"Left Trigger Full Pull"
"origin_xboxone_trigger_r_pull"	"Pravá spoušť"
"[english]origin_xboxone_trigger_r_pull"	"Right Trigger"
"origin_xboxone_trigger_r_click"	"Pravá spoušť – úplné stisknutí"
"[english]origin_xboxone_trigger_r_click"	"Right Trigger Full Pull"
"origin_xboxone_stick_l_move"	"Levá páčka – pohyb"
"[english]origin_xboxone_stick_l_move"	"Left Stick Movement"
"origin_xboxone_stick_l_click"	"Levá páčka – stisknutí"
"[english]origin_xboxone_stick_l_click"	"Left Stick Click"
"origin_xboxone_stick_l_dpad_n"	"Levá páčka – pohyb nahoru"
"[english]origin_xboxone_stick_l_dpad_n"	"Left Stick Move Up"
"origin_xboxone_stick_l_dpad_s"	"Levá páčka – pohyb dolů"
"[english]origin_xboxone_stick_l_dpad_s"	"Left Stick Move Down"
"origin_xboxone_stick_l_dpad_w"	"Levá páčka – pohyb doleva"
"[english]origin_xboxone_stick_l_dpad_w"	"Left Stick Move Left"
"origin_xboxone_stick_l_dpad_e"	"Levá páčka – pohyb doprava"
"[english]origin_xboxone_stick_l_dpad_e"	"Left Stick Move Right"
"origin_xboxone_stick_r_move"	"Pravá páčka – pohyb"
"[english]origin_xboxone_stick_r_move"	"Right Stick Movement"
"origin_xboxone_stick_r_click"	"Pravá páčka – stisknutí"
"[english]origin_xboxone_stick_r_click"	"Right Stick Click"
"origin_xboxone_stick_r_dpad_n"	"Pravá páčka – pohyb nahoru"
"[english]origin_xboxone_stick_r_dpad_n"	"Right Stick Move Up"
"origin_xboxone_stick_r_dpad_s"	"Pravá páčka – pohyb dolů"
"[english]origin_xboxone_stick_r_dpad_s"	"Right Stick Move Down"
"origin_xboxone_stick_r_dpad_w"	"Pravá páčka – pohyb doleva"
"[english]origin_xboxone_stick_r_dpad_w"	"Right Stick Move Left"
"origin_xboxone_stick_r_dpad_e"	"Pravá páčka – pohyb doprava"
"[english]origin_xboxone_stick_r_dpad_e"	"Right Stick Move Right"
"origin_xboxone_button_dpad_n"	"Směrový kříž – nahoru"
"[english]origin_xboxone_button_dpad_n"	"D-Pad Up"
"origin_xboxone_button_dpad_s"	"Směrový kříž – dolů"
"[english]origin_xboxone_button_dpad_s"	"D-Pad Down"
"origin_xboxone_button_dpad_w"	"Směrový kříž – doleva"
"[english]origin_xboxone_button_dpad_w"	"D-Pad Left"
"origin_xboxone_button_dpad_e"	"Směrový kříž – doprava"
"[english]origin_xboxone_button_dpad_e"	"D-Pad Right"
"origin_xboxone_shoulder_l"	"Levý nárazník"
"[english]origin_xboxone_shoulder_l"	"Left Shoulder"
"origin_xboxone_shoulder_r"	"Pravý nárazník"
"[english]origin_xboxone_shoulder_r"	"Right Shoulder"
"origin_xboxone_button_menu"	"Tlačítko Menu"
"[english]origin_xboxone_button_menu"	"Menu Button"
"origin_xboxone_button_view"	"Tlačítko Zobrazení"
"[english]origin_xboxone_button_view"	"View Button"
}
}
