"XBox360"
{
"origin_xbox360_button_a"	"A-painike"
"[english]origin_xbox360_button_a"	"A Button"
"origin_xbox360_button_b"	"B-painike"
"[english]origin_xbox360_button_b"	"B Button"
"origin_xbox360_button_x"	"X-painike"
"[english]origin_xbox360_button_x"	"X Button"
"origin_xbox360_button_y"	"Y-painike"
"[english]origin_xbox360_button_y"	"Y Button"
"origin_xbox360_trigger_l_pull"	"Vasen liipaisin"
"[english]origin_xbox360_trigger_l_pull"	"Left Trigger"
"origin_xbox360_trigger_l_click"	"Vasemman liipasimen vahva painallus"
"[english]origin_xbox360_trigger_l_click"	"Left Trigger Full Pull"
"origin_xbox360_trigger_r_pull"	"Oikea liipaisin"
"[english]origin_xbox360_trigger_r_pull"	"Right Trigger"
"origin_xbox360_trigger_r_click"	"Oikean liipaisimen vahva painallus"
"[english]origin_xbox360_trigger_r_click"	"Right Trigger Full Pull"
"origin_xbox360_stick_l_move"	"Vasemman sauvan liike"
"[english]origin_xbox360_stick_l_move"	"Left Stick Movement"
"origin_xbox360_stick_l_click"	"Vasemman sauvan painallus"
"[english]origin_xbox360_stick_l_click"	"Left Stick Click"
"origin_xbox360_stick_l_dpad_n"	"Vasen sauva ylös"
"[english]origin_xbox360_stick_l_dpad_n"	"Left Stick Move Up"
"origin_xbox360_stick_l_dpad_s"	"Vasen sauva alas"
"[english]origin_xbox360_stick_l_dpad_s"	"Left Stick Move Down"
"origin_xbox360_stick_l_dpad_w"	"Vasen sauva vasemmalle"
"[english]origin_xbox360_stick_l_dpad_w"	"Left Stick Move Left"
"origin_xbox360_stick_l_dpad_e"	"Vasen sauva oikealle"
"[english]origin_xbox360_stick_l_dpad_e"	"Left Stick Move Right"
"origin_xbox360_stick_r_move"	"Oikean sauvan liike"
"[english]origin_xbox360_stick_r_move"	"Right Stick Movement"
"origin_xbox360_stick_r_click"	"Oikean sauvan painallus"
"[english]origin_xbox360_stick_r_click"	"Right Stick Click"
"origin_xbox360_stick_r_dpad_n"	"Oikea sauva ylös"
"[english]origin_xbox360_stick_r_dpad_n"	"Right Stick Move Up"
"origin_xbox360_stick_r_dpad_s"	"Oikea sauva alas"
"[english]origin_xbox360_stick_r_dpad_s"	"Right Stick Move Down"
"origin_xbox360_stick_r_dpad_w"	"Oikea sauva vasemmalle"
"[english]origin_xbox360_stick_r_dpad_w"	"Right Stick Move Left"
"origin_xbox360_stick_r_dpad_e"	"Oikea sauva oikealle"
"[english]origin_xbox360_stick_r_dpad_e"	"Right Stick Move Right"
"origin_xbox360_button_dpad_n"	"Ristiohjain ylös"
"[english]origin_xbox360_button_dpad_n"	"D-Pad Up"
"origin_xbox360_button_dpad_s"	"Ristiohjain alas"
"[english]origin_xbox360_button_dpad_s"	"D-Pad Down"
"origin_xbox360_button_dpad_w"	"Ristiohjain vasemmalle"
"[english]origin_xbox360_button_dpad_w"	"D-Pad Left"
"origin_xbox360_button_dpad_e"	"Ristiohjain oikealle"
"[english]origin_xbox360_button_dpad_e"	"D-Pad Right"
"origin_xbox360_shoulder_l"	"Vasen bumper-painike"
"[english]origin_xbox360_shoulder_l"	"Left Shoulder"
"origin_xbox360_shoulder_r"	"Oikea bumper-painike"
"[english]origin_xbox360_shoulder_r"	"Right Shoulder"
"origin_xbox360_button_start"	"Start-painike"
"[english]origin_xbox360_button_start"	"Start Button"
"origin_xbox360_button_back"	"Back-painike"
"[english]origin_xbox360_button_back"	"Back Button"
}
