"XBox360"
{
"origin_xbox360_button_a"	"Кнопка A"
"[english]origin_xbox360_button_a"	"A Button"
"origin_xbox360_button_b"	"Кнопка B"
"[english]origin_xbox360_button_b"	"B Button"
"origin_xbox360_button_x"	"Кнопка X"
"[english]origin_xbox360_button_x"	"X Button"
"origin_xbox360_button_y"	"Кнопка Y"
"[english]origin_xbox360_button_y"	"Y Button"
"origin_xbox360_trigger_l_pull"	"Левый триггер"
"[english]origin_xbox360_trigger_l_pull"	"Left Trigger"
"origin_xbox360_trigger_l_click"	"Полное нажатие на левый триггер"
"[english]origin_xbox360_trigger_l_click"	"Left Trigger Full Pull"
"origin_xbox360_trigger_r_pull"	"Правый триггер"
"[english]origin_xbox360_trigger_r_pull"	"Right Trigger"
"origin_xbox360_trigger_r_click"	"Полное нажатие на правый триггер"
"[english]origin_xbox360_trigger_r_click"	"Right Trigger Full Pull"
"origin_xbox360_stick_l_move"	"Движение левого стика"
"[english]origin_xbox360_stick_l_move"	"Left Stick Movement"
"origin_xbox360_stick_l_click"	"Нажатие на левый стик"
"[english]origin_xbox360_stick_l_click"	"Left Stick Click"
"origin_xbox360_stick_l_dpad_n"	"Левый стик вверх"
"[english]origin_xbox360_stick_l_dpad_n"	"Left Stick Move Up"
"origin_xbox360_stick_l_dpad_s"	"Левый стик вниз"
"[english]origin_xbox360_stick_l_dpad_s"	"Left Stick Move Down"
"origin_xbox360_stick_l_dpad_w"	"Левый стик влево"
"[english]origin_xbox360_stick_l_dpad_w"	"Left Stick Move Left"
"origin_xbox360_stick_l_dpad_e"	"Левый стик вправо"
"[english]origin_xbox360_stick_l_dpad_e"	"Left Stick Move Right"
"origin_xbox360_stick_r_move"	"Движение правого стика"
"[english]origin_xbox360_stick_r_move"	"Right Stick Movement"
"origin_xbox360_stick_r_click"	"Нажатие на правый стик"
"[english]origin_xbox360_stick_r_click"	"Right Stick Click"
"origin_xbox360_stick_r_dpad_n"	"Правый стик вверх"
"[english]origin_xbox360_stick_r_dpad_n"	"Right Stick Move Up"
"origin_xbox360_stick_r_dpad_s"	"Правый стик вниз"
"[english]origin_xbox360_stick_r_dpad_s"	"Right Stick Move Down"
"origin_xbox360_stick_r_dpad_w"	"Правый стик влево"
"[english]origin_xbox360_stick_r_dpad_w"	"Right Stick Move Left"
"origin_xbox360_stick_r_dpad_e"	"Правый стик вправо"
"[english]origin_xbox360_stick_r_dpad_e"	"Right Stick Move Right"
"origin_xbox360_button_dpad_n"	"Крестовина вверх"
"[english]origin_xbox360_button_dpad_n"	"D-Pad Up"
"origin_xbox360_button_dpad_s"	"Крестовина вниз"
"[english]origin_xbox360_button_dpad_s"	"D-Pad Down"
"origin_xbox360_button_dpad_w"	"Крестовина влево"
"[english]origin_xbox360_button_dpad_w"	"D-Pad Left"
"origin_xbox360_button_dpad_e"	"Крестовина вправо"
"[english]origin_xbox360_button_dpad_e"	"D-Pad Right"
"origin_xbox360_shoulder_l"	"Левый бампер"
"[english]origin_xbox360_shoulder_l"	"Left Shoulder"
"origin_xbox360_shoulder_r"	"Правый бампер"
"[english]origin_xbox360_shoulder_r"	"Right Shoulder"
"origin_xbox360_button_start"	"Кнопка Start"
"[english]origin_xbox360_button_start"	"Start Button"
"origin_xbox360_button_back"	"Кнопка Back"
"[english]origin_xbox360_button_back"	"Back Button"
}
