"XBox360"
{
"origin_xbox360_button_a"	"Pulsante A"
"[english]origin_xbox360_button_a"	"A Button"
"origin_xbox360_button_b"	"Pulsante B"
"[english]origin_xbox360_button_b"	"B Button"
"origin_xbox360_button_x"	"Pulsante X"
"[english]origin_xbox360_button_x"	"X Button"
"origin_xbox360_button_y"	"Pulsante Y"
"[english]origin_xbox360_button_y"	"Y Button"
"origin_xbox360_trigger_l_pull"	"Grilletto sinistro"
"[english]origin_xbox360_trigger_l_pull"	"Left Trigger"
"origin_xbox360_trigger_l_click"	"Grilletto sinistro (Press. completa)"
"[english]origin_xbox360_trigger_l_click"	"Left Trigger Full Pull"
"origin_xbox360_trigger_r_pull"	"Grilletto destro"
"[english]origin_xbox360_trigger_r_pull"	"Right Trigger"
"origin_xbox360_trigger_r_click"	"Grilletto destro (Press. completa)"
"[english]origin_xbox360_trigger_r_click"	"Right Trigger Full Pull"
"origin_xbox360_stick_l_move"	"Levetta sinistra (Movimento)"
"[english]origin_xbox360_stick_l_move"	"Left Stick Movement"
"origin_xbox360_stick_l_click"	"Levetta sinistra (Click)"
"[english]origin_xbox360_stick_l_click"	"Left Stick Click"
"origin_xbox360_stick_l_dpad_n"	"Levetta sinistra (Su)"
"[english]origin_xbox360_stick_l_dpad_n"	"Left Stick Move Up"
"origin_xbox360_stick_l_dpad_s"	"Levetta sinistra (Giù)"
"[english]origin_xbox360_stick_l_dpad_s"	"Left Stick Move Down"
"origin_xbox360_stick_l_dpad_w"	"Levetta sinistra (Sinistra)"
"[english]origin_xbox360_stick_l_dpad_w"	"Left Stick Move Left"
"origin_xbox360_stick_l_dpad_e"	"Levetta sinistra (Destra)"
"[english]origin_xbox360_stick_l_dpad_e"	"Left Stick Move Right"
"origin_xbox360_stick_r_move"	"Levetta destra (Movimento)"
"[english]origin_xbox360_stick_r_move"	"Right Stick Movement"
"origin_xbox360_stick_r_click"	"Levetta destra (Clic)"
"[english]origin_xbox360_stick_r_click"	"Right Stick Click"
"origin_xbox360_stick_r_dpad_n"	"Levetta destra (Su)"
"[english]origin_xbox360_stick_r_dpad_n"	"Right Stick Move Up"
"origin_xbox360_stick_r_dpad_s"	"Levetta destra (Giù)"
"[english]origin_xbox360_stick_r_dpad_s"	"Right Stick Move Down"
"origin_xbox360_stick_r_dpad_w"	"Levetta destra (Sinistra)"
"[english]origin_xbox360_stick_r_dpad_w"	"Right Stick Move Left"
"origin_xbox360_stick_r_dpad_e"	"Levetta destra (Destra)"
"[english]origin_xbox360_stick_r_dpad_e"	"Right Stick Move Right"
"origin_xbox360_button_dpad_n"	"Croce direzionale (Su)"
"[english]origin_xbox360_button_dpad_n"	"D-Pad Up"
"origin_xbox360_button_dpad_s"	"Croce direzionale (Giù)"
"[english]origin_xbox360_button_dpad_s"	"D-Pad Down"
"origin_xbox360_button_dpad_w"	"Croce direzionale (Sinistra)"
"[english]origin_xbox360_button_dpad_w"	"D-Pad Left"
"origin_xbox360_button_dpad_e"	"Croce direzionale (Destra)"
"[english]origin_xbox360_button_dpad_e"	"D-Pad Right"
"origin_xbox360_shoulder_l"	"Dorsale sinistro"
"[english]origin_xbox360_shoulder_l"	"Left Shoulder"
"origin_xbox360_shoulder_r"	"Dorsale destro"
"[english]origin_xbox360_shoulder_r"	"Right Shoulder"
"origin_xbox360_button_start"	"Pulsante Start"
"[english]origin_xbox360_button_start"	"Start Button"
"origin_xbox360_button_back"	"Pulsante Back"
"[english]origin_xbox360_button_back"	"Back Button"
}
