"XBox360"
{
"origin_xbox360_button_a"	"A-knapp"
"[english]origin_xbox360_button_a"	"A Button"
"origin_xbox360_button_b"	"B-knapp"
"[english]origin_xbox360_button_b"	"B Button"
"origin_xbox360_button_x"	"X-knapp"
"[english]origin_xbox360_button_x"	"X Button"
"origin_xbox360_button_y"	"Y-knapp"
"[english]origin_xbox360_button_y"	"Y Button"
"origin_xbox360_trigger_l_pull"	"Venstre utløser"
"[english]origin_xbox360_trigger_l_pull"	"Left Trigger"
"origin_xbox360_trigger_l_click"	"Venstre utløser (helt inn)"
"[english]origin_xbox360_trigger_l_click"	"Left Trigger Full Pull"
"origin_xbox360_trigger_r_pull"	"Høyre utløser"
"[english]origin_xbox360_trigger_r_pull"	"Right Trigger"
"origin_xbox360_trigger_r_click"	"Høyre utløser (helt inn)"
"[english]origin_xbox360_trigger_r_click"	"Right Trigger Full Pull"
"origin_xbox360_stick_l_move"	"Venstre styrespak (bevegelse)"
"[english]origin_xbox360_stick_l_move"	"Left Stick Movement"
"origin_xbox360_stick_l_click"	"Venstre styrespak (trykk)"
"[english]origin_xbox360_stick_l_click"	"Left Stick Click"
"origin_xbox360_stick_l_dpad_n"	"Venstre styrespak (opp)"
"[english]origin_xbox360_stick_l_dpad_n"	"Left Stick Move Up"
"origin_xbox360_stick_l_dpad_s"	"Venstre styrespak (ned)"
"[english]origin_xbox360_stick_l_dpad_s"	"Left Stick Move Down"
"origin_xbox360_stick_l_dpad_w"	"Venstre styrespak (venstre)"
"[english]origin_xbox360_stick_l_dpad_w"	"Left Stick Move Left"
"origin_xbox360_stick_l_dpad_e"	"Venstre styrespak (høyre)"
"[english]origin_xbox360_stick_l_dpad_e"	"Left Stick Move Right"
"origin_xbox360_stick_r_move"	"Høyre styrespak (bevegelse)"
"[english]origin_xbox360_stick_r_move"	"Right Stick Movement"
"origin_xbox360_stick_r_click"	"Høyre styrespak (trykk)"
"[english]origin_xbox360_stick_r_click"	"Right Stick Click"
"origin_xbox360_stick_r_dpad_n"	"Høyre styrespak (opp)"
"[english]origin_xbox360_stick_r_dpad_n"	"Right Stick Move Up"
"origin_xbox360_stick_r_dpad_s"	"Høyre styrespak (ned)"
"[english]origin_xbox360_stick_r_dpad_s"	"Right Stick Move Down"
"origin_xbox360_stick_r_dpad_w"	"Høyre styrespak (venstre)"
"[english]origin_xbox360_stick_r_dpad_w"	"Right Stick Move Left"
"origin_xbox360_stick_r_dpad_e"	"Høyre styrespak (høyre)"
"[english]origin_xbox360_stick_r_dpad_e"	"Right Stick Move Right"
"origin_xbox360_button_dpad_n"	"Navigasjonsknapp opp"
"[english]origin_xbox360_button_dpad_n"	"D-Pad Up"
"origin_xbox360_button_dpad_s"	"Navigasjonsknapp ned"
"[english]origin_xbox360_button_dpad_s"	"D-Pad Down"
"origin_xbox360_button_dpad_w"	"Navigasjonsknapp venstre"
"[english]origin_xbox360_button_dpad_w"	"D-Pad Left"
"origin_xbox360_button_dpad_e"	"Navigasjonsknapp høyre"
"[english]origin_xbox360_button_dpad_e"	"D-Pad Right"
"origin_xbox360_shoulder_l"	"Venstre skulderknapp"
"[english]origin_xbox360_shoulder_l"	"Left Shoulder"
"origin_xbox360_shoulder_r"	"Høyre skulderknapp"
"[english]origin_xbox360_shoulder_r"	"Right Shoulder"
"origin_xbox360_button_start"	"Start-knapp"
"[english]origin_xbox360_button_start"	"Start Button"
"origin_xbox360_button_back"	"Back-knapp"
"[english]origin_xbox360_button_back"	"Back Button"
}
