"lang"
{
"Language"	"greek"
"Tokens"
{
"origin_xboxone_button_a"	"Κουμπί A"
"[english]origin_xboxone_button_a"	"A Button"
"origin_xboxone_button_b"	"Κουμπί B"
"[english]origin_xboxone_button_b"	"B Button"
"origin_xboxone_button_x"	"Κουμπί X"
"[english]origin_xboxone_button_x"	"X Button"
"origin_xboxone_button_y"	"Κουμπί Y"
"[english]origin_xboxone_button_y"	"Y Button"
"origin_xboxone_trigger_l_pull"	"Αριστερή σκανδάλη"
"[english]origin_xboxone_trigger_l_pull"	"Left Trigger"
"origin_xboxone_trigger_l_click"	"Πλήρες πάτημα αριστερής σκανδάλης"
"[english]origin_xboxone_trigger_l_click"	"Left Trigger Full Pull"
"origin_xboxone_trigger_r_pull"	"Δεξιά σκανδάλη"
"[english]origin_xboxone_trigger_r_pull"	"Right Trigger"
"origin_xboxone_trigger_r_click"	"Πλήρες πάτημα δεξιάς σκανδάλης"
"[english]origin_xboxone_trigger_r_click"	"Right Trigger Full Pull"
"origin_xboxone_stick_l_move"	"Κίνηση αριστερού μοχλού"
"[english]origin_xboxone_stick_l_move"	"Left Stick Movement"
"origin_xboxone_stick_l_click"	"Πάτημα αριστερού μοχλού"
"[english]origin_xboxone_stick_l_click"	"Left Stick Click"
"origin_xboxone_stick_l_dpad_n"	"Κίνηση αριστερού μοχλού πάνω"
"[english]origin_xboxone_stick_l_dpad_n"	"Left Stick Move Up"
"origin_xboxone_stick_l_dpad_s"	"Κίνηση αριστερού μοχλού κάτω"
"[english]origin_xboxone_stick_l_dpad_s"	"Left Stick Move Down"
"origin_xboxone_stick_l_dpad_w"	"Κίνηση αριστερού μοχλού αριστερά"
"[english]origin_xboxone_stick_l_dpad_w"	"Left Stick Move Left"
"origin_xboxone_stick_l_dpad_e"	"Κίνηση αριστερού μοχλού δεξιά"
"[english]origin_xboxone_stick_l_dpad_e"	"Left Stick Move Right"
"origin_xboxone_stick_r_move"	"Κίνηση δεξιού μοχλού"
"[english]origin_xboxone_stick_r_move"	"Right Stick Movement"
"origin_xboxone_stick_r_click"	"Πάτημα δεξιού μοχλού"
"[english]origin_xboxone_stick_r_click"	"Right Stick Click"
"origin_xboxone_stick_r_dpad_n"	"Κίνηση δεξιού μοχλού πάνω"
"[english]origin_xboxone_stick_r_dpad_n"	"Right Stick Move Up"
"origin_xboxone_stick_r_dpad_s"	"Κίνηση δεξιού μοχλού κάτω"
"[english]origin_xboxone_stick_r_dpad_s"	"Right Stick Move Down"
"origin_xboxone_stick_r_dpad_w"	"Κίνηση δεξιού μοχλού αριστερά"
"[english]origin_xboxone_stick_r_dpad_w"	"Right Stick Move Left"
"origin_xboxone_stick_r_dpad_e"	"Κίνηση δεξιού μοχλού δεξιά"
"[english]origin_xboxone_stick_r_dpad_e"	"Right Stick Move Right"
"origin_xboxone_button_dpad_n"	"D-Pad Πάνω"
"[english]origin_xboxone_button_dpad_n"	"D-Pad Up"
"origin_xboxone_button_dpad_s"	"D-Pad Κάτω"
"[english]origin_xboxone_button_dpad_s"	"D-Pad Down"
"origin_xboxone_button_dpad_w"	"D-Pad Αριστερά"
"[english]origin_xboxone_button_dpad_w"	"D-Pad Left"
"origin_xboxone_button_dpad_e"	"D-Pad Δεξιά"
"[english]origin_xboxone_button_dpad_e"	"D-Pad Right"
"origin_xboxone_shoulder_l"	"Αριστερό μπροστινό κουμπί"
"[english]origin_xboxone_shoulder_l"	"Left Shoulder"
"origin_xboxone_shoulder_r"	"Δεξί μπροστινό κουμπί"
"[english]origin_xboxone_shoulder_r"	"Right Shoulder"
"origin_xboxone_button_menu"	"Κουμπί μενού"
"[english]origin_xboxone_button_menu"	"Menu Button"
"origin_xboxone_button_view"	"Κουμπί προβολής"
"[english]origin_xboxone_button_view"	"View Button"
}
}
